R 800 600  sadasdas

S ./path_to_the_sprite_texture

NO ./path_to_the_north_texture sadasdasd
SO ./path_to_the_south_texture
WE ./path_to_the_west_texture
EA ./path_to_the_east_texture


F 220,100,0
C 2,2,2

1111111111111111111111111
1000000000110000000000001
1000000000110000002000001
1000000000000000000000001
1010111110110000011100001
100000000011000001110111111111111
11110111111111011100000010001
11110111111111011101010010001
11000000110101011100000010001
10002000000000001100000010001
10000000000000001101010010001
11000001110101011111011110N0111
1111011111101011101111010001 
1111111111111111111111111111